SPPPPWPPPPPWPPPPPWPPPWPPPWP
WWWWPWPWWWPWPWWWPWPWPWPWPWP
PPPWPPPWPWPPPWPWPPPWPPPWPPP
PWPWWWWWPWWWWWPWWWWWWWWWWWP
PWPPPPPPPPPPPPPWPPPPPPPPPWP
PWPWPWWWWWWWWWWWPWPWWWWWPWP
PWPWPWPPPPPPPWPPPWPWPPPPPWP
WWPWWWPWWWWWPWPWWWPWWWWWWWP
PPPWPPPWPPPWPPPWPWPPPPPWPPP
PWWWPWWWPWWWWWWWPWWWWWPWPWW
PPPWPWPWPPPPPPPPPPPWPPPWPWP
WWPWPWPWPWWWWWWWPWPWPWPWPWP
PPPWPWPWPPPPPWPPPWPWPWPWPWP
PWWWPWPWWWPWWWPWWWPWPWPWPWP
PPPPPWPPPPPWPPPWPPPWPWPWPPP
PWWWWWWWWWWWPWPWWWWWPWPWWWP
PWPPPPPPPPPPPWPWPPPWPWPPPWP
PWPWWWWWWWWWWWPWPWPWPWWWWWP
PPPWPPPWPPPPPWPWPWPPPWPPPWP
WWWWPWPWPWPWWWPWPWWWWWPWPWP
PPPPPWPPPWPPPWPWPPPWPPPWPWP
PWWWWWWWWWWWPWPWWWPWPWWWPWP
PPPPPWPWPPPPPWPPPWPPPWPPPWP
WWWWPWPWPWWWWWWWPWWWWWPWPWP
PPPPPWPWPPPPPPPWPPPPPWPWPWP
PWWWWWPWWWWWPWWWWWWWPWPWWWP
PPPPPPPPPPPWPPPPPPPPPWPPPPF
