SPPPPPPWPPPPPPPWPPPPPPPPP
WWWWWWPWPWWWPWWWPWWWWWPWP
PPPPPWPWPPPWPPPPPWPPPPPWP
WWWWPWPWWWWWWWWWWWPWWWWWP
PPPPPWPPPPPPPWPPPWPPPWPPP
PWWWWWWWWWWWPWPWPWWWPWPWW
PWPPPPPPPWPWPPPWPPPPPWPPP
PWPWWWPWPWPWWWWWWWWWWWWWP
PWPWPPPWPWPPPPPWPPPWPPPWP
PWPWPWWWPWPWWWWWPWPWPWPWP
PWPWPWPPPPPWPPPPPWPPPWPWP
PWPWPWPWWWWWPWWWWWWWWWPWP
PPPWPWPWPWPPPWPPPWPPPPPWP
PWWWPWPWPWPWWWPWWWPWPWWWP
PWPPPWPPPWPWPPPPPWPWPWPPP
PWPWWWWWWWPWWWWWPWPWWWPWW
PWPPPPPPPWPPPWPPPWPPPPPWP
PWWWWWWWPWWWPWPWPWWWWWWWP
PPPPPPPWPPPWPPPWPPPPPWPPP
WWWWWWPWWWPWWWWWWWWWPWWWP
PPPWPPPWPWPPPPPPPPPWPWPPP
PWPWPWWWPWWWPWPWWWWWPWPWP
PWPWPPPWPPPWPWPWPPPWPPPWP
PWWWWWPWPWPWPWWWPWPWWWWWP
PPPPPPPPPWPWPPPPPWPPPPPPF
