SWPPPPPWPPPPPPP
PWPWPWWWPWPWWWW
PWPWPPPPPWPPPPP
PWWWWWPWWWWWWWP
PPPPPWPWPPPPPPP
WWWWPWWWPWWWWWP
PPPWPPPPPWPPPPP
PWWWWWWWWWPWWWW
PPPPPPPPPWPWPPP
PWPWPWWWWWPWWWP
PWPWPWPPPWPPPPP
WWPWPWPWPWWWWWP
PPPWPWPWPPPWPPP
PWWWWWPWWWPWPWW
PPPPPPPPPWPPPPF
