2
SWPPPPPPPPPWPPPPPPPWPPPPPPP
PWPWWWWWWWPWPWWWWWPWWWPWWWW
PWPPPPPWPPPPPWPPPWPPPWPPPPP
PWWWPWPWWWWWWWPWPWWWPWWWWWP
PPPWPWPPPPPPPPPWPWPPPPPPPWP
WWPWWWWWWWWWPWWWPWWWWWWWPWP
PWPPPPPPPPPWPPPWPPPWPPPPPPP
PWWWWWWWWWPWWWWWWWPWWWWWWWP
PWPPPPPPPWPPPPPWPPPWPPPPPWP
PWPWWWWWPWWWWWPWPWWWPWWWPWW
PWPWPPPWPPPPPWPWPPPPPWPWPPP
PWPWPWWWWWWWPWPWWWWWPWPWWWP
PPPWPPPPPPPWPWPPPPPWPPPPPWP
PWWWWWPWWWWWPWWWWWPWWWWWWWP
PWPPPPPWPPPPPWPPPWPWPPPWPPP
PWPWWWPWPWWWPWPWPWPWPWPWPWP
PPPWPPPWPPPWPWPWPWPPPWPPPWP
WWWWPWWWWWPWWWPWPWWWWWWWWWP
PPPWPPPWPWPPPPPWPPPPPPPPPWP
PWWWWWPWPWWWWWWWPWWWWWWWPWP
PPPPPWPWPPPPPPPWPPPWPPPPPWP
PWWWPWPWPWPWWWWWWWPWPWWWWWP
PPPWPWPWPWPPPWPPPPPWPPPPPWP
WWPWPWPWPWWWPWPWWWWWPWWWWWP
PPPWPWPWPWPPPWPWPPPWPWPPPPP
PWWWPWPWWWPWPWPWPWPWWWPWWWW
PPPWPPPPPPPWPWPPPWPPPPPPPPF
