SPPWPPPPP
WWPWWWPWP
PWPPPWPWP
PWWWPWWWP
PPPWPPPPP
PWWWWWWWP
PWPPPWPPP
PWPWPWPWW
PPPWPPPPF
