WWWWWWWWWW
WPWPPWPWWW
WPWPWWPWWW
WPPPWWPWWW
WWWPPPPWWW
WPPPWWWWWW
WPWWWPPPWW
WPPWPPWWWW
WWPPPPPPPW
WWWWWWWWWW
