WWWWWWWWWWWWWWWWWWWWWWWWWWWWWWWWW
WWWWWWWWWWWWWWWWWWWWWWWWWWWWWWWWW
WWPPPPPPPPPPPPPPWPPPPPWPPPPPPPPWW
WWPPPPPPPPPPPPPPWPPPPPWPPPPPPPPWW
WWPPWWWWWWWWWWPPWWWWPPWPPWWWWPPWW
WWPPWWWWWWWWWWPPWWWWPPWPPWWWWPPWW
WWPPPPPPPPPPPWPPPPPWPPWPPWPPPPPWW
WWPPPPPPPPPPPWPPPPPWPPWPPWPPPPPWW
WWWWWWWWWWWPPWWWWPPWPPWPPWPPWWWWW
WWWWWWWWWWWPPWWWWPPWPPWPPWPPWWWWW
WWPPWPPPPPWPPPPPWPPPPPWPPWPPPPPWW
WWPPWPPPPPWPPPPPWPPPPPWPPWPPPPPWW
WWPPWPPWPPWWWWPPWWWWWWWPPWWWWPPWW
WWPPWPPWPPWWWWPPWWWWWWWPPWWWWPPWW
WWPPPPPWPPPPPPPPWPPPPPWPPWPPPPPWW
WWPPPPPWPPPPPPPPWPPPPPWPPWPPPPPWW
WWWWWWWWWWWPPWWWWWWWPPWPPWPPWWWWW
WWWWWWWWWWWPPWWWWWWWPPWPPWPPWWWWW
WWPPPPPPPPWPPPPPPPPWPPWPPWPPPPPWW
WWPPPPPPPPWPPPPPPPPWPPWPPWPPPPPWW
WWPPWWWWPPWWWWWWWPPWPPWWWWWWWPPWW
WWPPWWWWPPWWWWWWWPPWPPWWWWWWWPPWW
WWPPWPPWPPPPPPPPPPPPPPPPPPPPWPPWW
WWPPWPPWPPPPPPPPPPPPPPPPPPPPWPPWW
WWPPWPPWWWWWWWWWWPPWPPWWWWPPWPPWW
WWPPWPPWWWWWWWWWWPPWPPWWWWPPWPPWW
WWPPWPPWPPPPPPPPWPPWPPPPPWPPPPPWW
WWPPWPPWPPPPPPPPWPPWPPPPPWPPPPPWW
WWPPWPPWWWWWWWPPWPPWWWWPPWWWWWWWW
WWPPWPPWWWWWWWPPWPPWWWWPPWWWWWWWW
WWPPWPPWPPPPPWPPPPPWPPPPPWPPPPPWW
WWPPWPPWPPPPPWPPPPPWPPPPPWPPPPPWW
WWPPWPPWPPWPPWWWWWWWPPWPPWPPWPPWW
WWPPWPPWPPWPPWWWWWWWPPWPPWPPWPPWW
WWPPPPPWPPWPPWPPPPPWPPWPPPPPWPPWW
WWPPPPPWPPWPPWPPPPPWPPWPPPPPWPPWW
WWPPWWWWWWWPPWPPWWWWPPWWWWWWWPPWW
WWPPWWWWWWWPPWPPWWWWPPWWWWWWWPPWW
WWPPPPPPPPPPPWPPPPPPPPWPPPPPPPPWW
WWPPPPPPPPPPPWPPPPPPPPWPPPPPPPPWW
WWWWWWWWWWWWWWWWWWWWWWWWWWWWWWWWW
WWWWWWWWWWWWWWWWWWWWWWWWWWWWWWWWW
